BAL = "countries/Baltic Commonwealth"
FIN = "countries/Finnish Khaganate"
KIE = "countries/Kievan Rus"
RUH = "countries/Russian Hegemony"
DEA = "countries/Dead Circle"
SAM = "countries/Grand Confederation of Samara"
RUP = "countries/Principality of Russia"
IND = "countries/Industrial Wasteland"
THU = "countries/Thulean Brotherhood"
USR = "countries/Union of Sycthian Republics"
NRF = "countries/Nazbol"
TTC = "countries/Turkic Tribal Confederation"
I01 = "countries/Iron Lord 1"
I02 = "countries/Iron Lord 2"
I03 = "countries/Iron Lord 3"
I04 = "countries/Iron Lord 4"
I05 = "countries/Iron Lord 5"
I06 = "countries/Iron Lord 6"
I07 = "countries/Iron Lord 7"
I08 = "countries/Iron Lord 8"
I09 = "countries/Iron Lord 9"
SCO = "countries/Clans of Scotland"
RFM = "countries/Republic of Free Men"
CRI = "countries/Realm of the Crimson King"
CAM = "countries/Kingdom of Camelot"
WCB = "countries/Worker's Council of Britain"
LON = "countries/London Authority"
BFS = "countries/British Fascist State"
VLA = "countries/Vladivostok Directorate"
FER = "countries/Far Eastern Republic"
CHR = "countries/Lands of Christ"
IRK = "countries/Host of Irkusts"
GAZ = "countries/Gazprom Property"
NIR = "countries/Nirvana"
KAZ = "countries/Kazakh Khanate"
SOL = "countries/Italian Solar Empire"
KYU = "Kyushu Republic"
JAI = "Empire of Japan"
SMI = "countries/Sapmi.txt"
JMT = "countries/Jamtlann.txt"
NOR = "countries/Norge.txt"
GOT = "countries/Gothland.txt"
SWE = "countries/Sverige.txt"
SML = "countries/Smolandia.txt"
DEN = "countries/Danmark.txt"
DY1 = "countries/Daiyamo 1"
DY2 = "countries/Daiyamo 2"
DY3 = "countries/Daiyamo 3"
DY4 = "countries/Daiyamo 4"
DY5 = "countries/Daiyamo 5"
UST = "countries/The United States"
SLA = "countries/Slavic Empire"
CRO = "countries/Croai Republic"
SES = "countries/Serbian National State"
SEK = "countries/Kingdom of Serbia"
NRB = "countries/New Republic of Belgrade"
SEC = "countries/Serb Confederation"
SCI = "countries/Catholic State of Italy"
TAI = "countries/Republic of Taiwan"
CWU = "countries/Chinese Workers Union"
PRC = "countries/People's Republic of China"
JIA = "countries/Jiangsu Clique"
GOB = "countries/Gobi Confederation"
HKG = "countries/Hong Kong"
GYU = "countries/Guanyu Dynasty"
IOC = "countries/Indochinese Occupation Corps"
XIN = "countries/Xinjiang Sultanate"
TPR = "countries/Tibetian People's Republic"
HUB = "countries/Kingdom of Hubei"
GUI = "countries/Guizhou Authority"
FUZ = "countries/Fuzhou Military Commision"
RCC = "countries/Republic of Central China"
SVI = "countires/South Vietnam"
KHM = "countries/Khmer Union"
KOR = "countries/People's Republic of Korea"
PRF = "countries/People's Republic of France"
BRI = "countries/National Council of Brittany"
FFT = "countries/Free French Territory"
FRS = "countries/French State"
SGR = "countries/South German Republic"
EGE = "countries/East Germany"
CSG = "countries/Communist State of Germany"
SRE = "countries/Socialist Reich"
DNS = "countries/Danish National State"
FRI = "Frisia"